11111111111111111111111111
10010000000C000C001100C111
111001111100111C1000C00001
1P0011E00000C0000000C00011
111110001000C0001000C11111
110000111000100010C000C011
11111111111111111111111111