111111111111111111111
10010000000C000100C01
100001111100111C10001
1P0011E00000C0000C001
1C0000111000C00011001
111111111111111111111